XXXXXXXXXXXXXXXXXXXXXXXXXXXXXXXXXXXXXXXXXXXXXXXXXXXX
XXXXXXXXXXXXXXXXXXXXXXXXXXXXXXXXXXXXXXXXXXXXXXXXXXXX
XXXXXXXXXXXXXXXXXXXXXXXXXXXXXXXXXXXXXXXXXXXXXXXXXXXX
XXXXXXXXXXXXXXXXXXXXXXXXXXXXXXXXXXXXXXXXXXXXXXXXXXXX
XXXX1212XXXX1212XXXX1212XXXX1212XXXX1212XXXX1212XXXX
XXXX2121XXXX2121XXXX2121XXXX2121XXXX2121XXXX2121XXXX
XXXX1212XXXX1212XXXX1212XXXX1212XXXX1212XXXX1212XXXX
XXXX2121XXXX2121XXXX2121XXXX2121XXXX2121XXXX2121XXXX
XXXX1212XXXX1212XXXX1212XXXX1212XXXX1212XXXX1212XXXX
XXXX2121XXXX2121XXXX2121XXXX2121XXXX2121XXXX2121XXXX
XXXX1212XXXX1212XXXX1212XXXX1212XXXX1212XXXX1212XXXX
XXXX2121XXXX2121XXXX2121XXXX2121XXXX2121XXXX2121XXXX
XXXX1212XXXX1212XXXX1212SXSX1212XXXX1212XXXX1212XXXX
XXXX2121XXXX2121XXXX2121XXXX2121XXXX2121XXXX2121XXXX
XXXX1212XXXX1212XXXX1212SXSX1212XXXX1212XXXX1212XXXX
XXXX2121XXXX2121XXXX2121XXXX2121XXXX2121XXXX2121XXXX
XXXX1212XXXX1212XXXX1212XXXX1212XXXX1212XXXX1212XXXX
XXXX2121XXXX2121XXXX2121XXXX2121XXXX2121XXXX2121XXXX
XXXX1212XXXX1212XXXXXXXXXXXXXXXXXXXX1212XXXX1212XXXX
XXXX2121XXXX2121XXXXXXXXXXXXXXXXXXXX2121XXXX2121XXXX
XXXX1212XXXX1212XXXXXXXXXXXXXXXXXXXX1212XXXX1212XXXX
XXXX2121XXXX2121XXXXXXXXXXXXXXXXXXXX2121XXXX2121XXXX
XXXXXXXXXXXXXXXXXXXX1212XXXX1212XXXXXXXXXXXXXXXXXXXX
XXXXXXXXXXXXXXXXXXXX2121XXXX2121XXXXXXXXXXXXXXXXXXXX
XXXXXXXXXXXXXXXXXXXX1212XXXX1212XXXXXXXXXXXXXXXXXXXX
XXXXXXXXXXXXXXXXXXXX2121XXXX2121XXXXXXXXXXXXXXXXXXXX
1212XXXX12121212XXXXXXXXXXXXXXXXXXXX12121212XXXX1212
2121XXXX21212121XXXXXXXXXXXXXXXXXXXX21212121XXXX2121
SXSXXXXX12121212XXXXXXXXXXXXXXXXXXXX12121212XXXXSXSX
XXXXXXXX21212121XXXXXXXXXXXXXXXXXXXX21212121XXXXXXXX
XXXXXXXXXXXXXXXXXXXX1212XXXX1212XXXXXXXXXXXXXXXXXXXX
XXXXXXXXXXXXXXXXXXXX2121XXXX2121XXXXXXXXXXXXXXXXXXXX
XXXXXXXXXXXXXXXXXXXX121212121212XXXXXXXXXXXXXXXXXXXX
XXXXXXXXXXXXXXXXXXXX212121212121XXXXXXXXXXXXXXXXXXXX
XXXX1212XXXX1212XXXX121212121212XXXX1212XXXX1212XXXX
XXXX2121XXXX2121XXXX212121212121XXXX2121XXXX2121XXXX
XXXX1212XXXX1212XXXX1212XXXX1212XXXX1212XXXX1212XXXX
XXXX2121XXXX2121XXXX2121XXXX2121XXXX2121XXXX2121XXXX
XXXX1212XXXX1212XXXX1212XXXX1212XXXX1212XXXX1212XXXX
XXXX2121XXXX2121XXXX2121XXXX2121XXXX2121XXXX2121XXXX
XXXX1212XXXX1212XXXX1212XXXX1212XXXX1212XXXX1212XXXX
XXXX2121XXXX2121XXXX2121XXXX2121XXXX2121XXXX2121XXXX
XXXX1212XXXX1212XXXXXXXXXXXXXXXXXXXX1212XXXX1212XXXX
XXXX2121XXXX2121XXXXXXXXXXXXXXXXXXXX2121XXXX2121XXXX
XXXX1212XXXX1212XXXXXXXXXXXXXXXXXXXX1212XXXX1212XXXX
XXXX2121XXXX2121XXXXXXXXXXXXXXXXXXXX2121XXXX2121XXXX
XXXX1212XXXX1212XXXXXX12121212XXXXXX1212XXXX1212XXXX
XXXX2121XXXX2121XXXXXX21212121XXXXXX2121XXXX2121XXXX
XXXXXXXXXXXXXXXXXXXXXX12TXXX12XXXXXXXXXXXXXXXXXXXXXX
XXXXXXXXXXXXXXXXXXXXXX21XXXX21XXXXXXXXXXXXXXXXXXXXXX
XXXXXXXXXXXXXXXXXXXXXX12XXXX12XXXXXXXXXXXXXXXXXXXXXX
XXXXXXXXXXXXXXXXXXXXXX21XXXX21XXXXXXXXXXXXXXXXXXXXXX
